EOEEEEEEE
#####EEEE
EXEE#EE##
EE#E#EEEE
E##EEE#EE